	
2	T UW 
A	AH
A(2)	EY
ALMONDS	AA L M AH N D Z
AMBROSIA	AE M B R OW ZH AH
AND	AH N D
AND(2)	AE N D
APPETIZER	AE P AH T AY Z ER
APPETIZING	AE P IH T AY Z IH NG
APPLE	AE P AH L
APPLES	AE P AH L Z
APPLESAUCE	AE P AH L S AO S
APRICOT	EY P R AH K AA T
APRICOTS	AE P R AH K AA T S
ARKTIKA	AA R K T IH K AH 
ARTIC	AA R T IH K 
ARTICHOKES	AA R T IH CH OW K S
AS	AE Z
AS(2)	EH Z
ASPARAGUS	AH S P EH R AH G AH S
ASSORTED	AH S AO R T IH D
ASSORTMENT	AH S AO R T M AH N T
AU	OW
AUBERGINE	AO B ER JH AH N 
AZU	AE Z UW 
BACON	B EY K AH N
BAKED	B EY K T
BALL	B AO L
BALS	B AE L Z 
BALTIKA	B AO L T IH K AH 
BANANA	B AH N AE N AH
BAR	B AA R
BARBECUED	B AA R B IH K Y UW D
BARLEY	B AA R L IY
BASIL	B AE Z AH L
BEAN	B IY N
BEANS	B IY N Z
BEEF	B IY F
BEET	B IY T
BERRIES	B EH R IY Z
BERRY	B EH R IY
BISCUIT	B IH S K AH T
BISCUITS	B IH S K AH T S
BISON	B AY S AH N
BLACK	B L AE K
BLUEBERRY	B L UW B EH R IY
BLUEBERRYRASPBERRY	B L UW B EH R R AE S B EH R IY 
BORODINSKIY	B R AH D IH N S K IH IY 
BORSCH	B AO R SH
BOUNTY	B AW N T IY
BRAISED	B R EY Z D
BRAN	B R AE N
BREAD	B R EH D
BREAKFAST	B R EH K F AH S T
BREAM	B R IY M
BREAST	B R EH S T
BREW	B R UW
BRISKET	B R IH S K AH T
BROCCOLI	B R AA K AH L IY
BROCCOLI(2)	B R AA K L IY
BROWN	B R AW N
BROWNIE	B R AW N IY
BUCKWHEAT	B AH K W IY T
BULGARIANSTYLE	B AH L G EH R IY AH N S T AY L 
BUTTER	B AH T ER
BUTTERSCOTCH	B AH T ER S K AA CH
CABBAGE	K AE B AH JH
CABBAGE(2)	K AE B IH JH
CAKE	K EY K
CALF'S	K AE F S
CANADIAN	K AH N EY D IY AH N
CANDIED	K AE N D IY D
CANDY	K AE N D IY
CAPERS	K EY P ER Z
CARIBBEAN	K ER IH B IY AH N
CARIBBEAN(2)	K EH R IH B IY AH N
CARROT	K AE R AH T
CARROT(2)	K EH R AH T
CARROTS	K AE R AH T S
CARROTS(2)	K EH R AH T S
CASHEW	K AE SH UW
CASHEWS	K AE SH UW Z
CASSEROLE	K AE S ER OW L
CAULIFLOWER	K AA L AH F L AW ER
CELERIAC	S EH L ER IY AE K 
CEREAL	S IH R IY AH L
CHAR	CH AA R
CHEDDAR	CH EH D ER
CHEEKS	CH IY K S
CHEERIOS	CH IH R IY OW S
CHEESE	CH IY Z
CHEESECAKE	CH IY Z K EY K
CHEESY	CH IY Z IY
CHERRIES	CH EH R IY Z
CHERRY	CH EH R IY
CHESTNUT	CH EH S N AH T
CHESTNUT(2)	CH EH S T N AH T
CHEX	CH EH K S 
CHICKEN	CH IH K AH N
CHICKENPINEAPPLE	CH IH K AH N P IH N AE P AH L 
CHILI	CH IH L IY
CHIPOTLE	CH IH P AA T AH L 
CHIPS	CH IH P S
CHOCOLATE	CH AO K L AH T
CHOCOLATES	CH AO K L AH T S
CHOP	CH AA P
CHOPPED	CH AA P T
CIDER	S AY D ER
CINNAMON	S IH N AH M AH N
CITRUS	S IH T R AH S
CLEAR	K L IH R
COATED	K OW T AH D
COATED(2)	K OW T IH D
COBBLER	K AA B L ER
COCKTAIL	K AA K T EY L
COCOA	K OW K OW
COFFEE	K AA F IY
COFFEE(2)	K AO F IY
COINS	K OY N Z
COMPOTE	K AA M P OW T
CONFIT	K AA N F IH T 
CONSOMME	K AH N S AH M 
COOKED	K UH K T
COOKIES	K UH K IY Z
CORIANDER	K AO R IY AE N D ER
CORN	K AO R N
CORNBREAD	K AO R N B R EH D
CORNFLAKES	K AO R N F L EY K S 
COTTAGE	K AA T AH JH
COTTAGE(2)	K AA T IH JH
COUNTRY	K AH N T R IY
COUSCOUS	K S K AH S 
COVERED	K AH V ER D
COWBERRY	K AW B EH R IY 
CRACKERS	K R AE K ER Z
CRANAPPLE	K R AE N AH P AH L 
CRANBERRIES	K R AE N B EH R IY Z
CRANBERRIESRASPBERRY	K R AE N B EH R IY Z R AE S B EH R IY 
CRANBERRY	K R AE N B EH R IY
CRAWFISH	K R AO F IH SH
CREAM	K R IY M
CREAMED	K R IY M D
CROUTONS	K R AW T AH N Z 
CRUSHED	K R AH SH T
CUCUMBER	K Y UW K AH M B ER
CURD	K ER D
CURRANT	K AA ER AH N T 
CURRY	K AH R IY
CURRY(2)	K ER IY
D	D IY
DALBHAT	D AE L B AH T 
DARK	D AA R K
DATA	D EY T AH
DATA(2)	D AE T AH
DAVID	D EY V IH D
DAY	D EY
DECAF	D IY K AE F
DELI	D EH L IY
DESSERT	D IH Z ER T
DIP	D IH P
DRESSING	D R EH S IH NG
DRIED	D R AY D
DRINK	D R IH NG K
DRINKING	D R IH NG K IH NG
DROP	D R AA P
DROP(2)	D R AO P
DUCK	D AH K
EGG	EH G
EGGPLANT	EH G P L AE N T
EGGS	EH G Z
ENCHILADA	EH N CH IH L AA D AH
ENRICHED	EH N R IH CH T
ESSENTIAL	IH S EH N SH AH L
ESSENTIAL(2)	IY S EH N SH AH L
ESSENTIAL(3)	AH S EH N CH AH L
ESSENTIAL(4)	IY S EH N CH AH L
ETOUFFEE	EH T OW UW F IY 
FAJITAS	F AH JH IY T AH Z
FAJITAS(2)	F AH HH IY T AH Z
FIESTA	F IY EH S T AH
FIVE	F AY V
FLAT	F L AE T
FLAVOR	F L EY V ER
FONDANT	F AA N D AH N T 
FOOD	F UW D
FOXBERRY	F AA K S B EH R IY 
FREEZE	F R IY Z
FREEZEDRIED	F R IY Z AH D R AY D 
FRENCH	F R EH N CH
FRIED	F R AY D
FRIED(2)	F R IY D
FRUIT	F R UW T
FRUITSOURCEBLUEBERRY	F R UW IH T S AO R CH B L UW B EH R IY 
FRUITSOURCECHERRY	F R UW IH T S AO R S IH K EH R IY 
FRUITSOURCETROPICAL	F R UW IH T S AO R S T R AA P IH K AH L 
GLUCOSE	G L UW K OW S
GOULASH	G UW L AA SH
GRAIN	G R EY N
GRANOLA	G R AH N OW L AH
GRAPE	G R EY P
GRAPEFRUIT	G R EY P F R UW T
GRATIN	G R EY T AH N 
GREEN	G R IY N
GRILLED	G R IH L D
GRITS	G R IH T S
GRUEL	G R UW IH L
GUMBO	G AH M B OW
GYUVECH	G Y Y AH V IH CH 
HARD	HH AA R D
HAZELNUTS	HH EY Z AH L N AH T S
HERBS	ER B Z
HIGH	HH AY
HINT	HH IH N T
HOISON	HH OY S AH N 
HOME	HH OW M
HOMESTYLE	HH OW M S T AY L 
HONEY	HH AH N IY
HOT	HH AA T
IN	IH N
ITALIAN	IH T AE L Y AH N
JAM	JH AE M
JAPANESE	JH AE P AH N IY Z
JC	JH EY S IY 
JELLIED	JH EH L IY D
JELLY	JH EH L IY
JERKY	JH ER K IY
JUICE	JH UW S
KASHA	K AA SH AH
KETCHUP	K EH CH AH P
KHARCHO	K AA R CH OW 
KING	K IH NG
KOFEYNIY	K OW F N AH IY 
KONA	K OW N AH
KRISPIES	K R IH S P IY Z
KURAGA	K R AA G AH 
LAMB	L AE M
LASAGNA	L AA S AA N Y AH
LASAGNA(2)	L AH Z AA N Y AH
LEAF	L IY F
LEDOKAL	L EH D AH K AA L 
LEL	L EH L 
LEMON	L EH M AH N
LEMONADE	L EH M AH N EY D
LEMONLIME	L EH M OW N L AY M 
LENTIL	L EH N T AH L
LIME	L AY M
LINKS	L IH NG K S
LIVER	L IH V ER
LIVERS	L IH V ER Z
LOIN	L OY N
LS	EH L EH S
LUBITELSKIY	L UW B IH T EH L S K AH IY 
MACADAMIA	M AE K AH D EY M IY AH
MACARONI	M AE K ER OW N IY
MACKEREL	M AE K ER AH L
MANGO	M AE NG G OW
MAPLE	M EY P AH L
MARJORAM	M AA JH ER AH M
MASHED	M AE SH T
MAYONNAISE	M EY AH N EY Z
MEAT	M IY T
MEATLOAF	M IY T L OW F
MEATS	M IY T S
MEDLEY	M EH D L IY
MEIJIN	M EY JH IH N 
MENTON	M EH N T AH N
MERINGUE	M EH R IH NG 
MEXICAN	M EH K S AH K AH N
MILK	M IH L K
MINESTRONE	M AY N AH S T R OW N 
MISO	M IY S OW 
MIX	M IH K S
MIXED	M IH K S T
MOCHA	M OW K AH
MOSCOW	M AA S K OW
MOSCOW(2)	M AO S K AW
MUESLI	M Y UW S L IY 
MUFFIN	M AH F AH N
MUSHROOM	M AH SH R UW M
MUSHROOMS	M AH SH R UW M Z
MUSTARD	M AH S T ER D
MUTTON	M AH T AH N
NATURE'S	N EY CH ER Z
NOODLE	N UW D AH L
NOODLES	N UW D AH L Z
NUT	N AH T
NUTS	N AH T S
OAT	OW T
OATMEAL	OW T M IY L
OF	AH V
OLIVE	AA L AH V
OLIVE(2)	AA L IH V
OMELET	AA M L AH T
ONE	W AH N
ONE(2)	HH W AH N
OOLONG	UW L AO NG
ORANGE	AO R AH N JH
ORANGE(2)	AO R IH N JH
ORANGEGRAPEFRUIT	AO R AH N JH AH G R EY P F R UW T 
ORANGEMANGO	AO R AH N JH M AE NG G OW 
ORANGEPINEAPPLE	AO R AH N G IH P IH N AE P AH L 
ORIGINAL	ER IH JH AH N AH L
OSENNYAYA	OW S IH N Y AY AH 
PACIFIC	P AH S IH F IH K
PALAK	P AE L AH K 
PAN	P AE N
PARMENTIER	P AA R M AH N T IY ER
PASTA	P AA S T AH
PASTE	P EY S T
PATE	P EY T
PATTIE	P AE T IY
PEA	P IY
PEACH	P IY CH
PEACHES	P IY CH AH Z
PEACHES(2)	P IY CH IH Z
PEANUT	P IY N AH T
PEANUTS	P IY N AH T S
PEARS	P EH R Z
PEAS	P IY Z
PEASANT	P EH Z AH N T
PEMMICAN	P EH M IH K AH N 
PEPPERED	P EH P ER D
PEPPERMINT	P EH P ER M IH N T
PEPPERS	P EH P ER Z
PERCH	P ER CH
PESTO	P EH S T OW 
PICKLED	P IH K AH L D
PIE	P AY
PIKE	P AY K
PILAF	P IH L AE F 
PINEAPPLE	P AY N AE P AH L
PIPSI	P IH P S IY 
PIQUANT	P IY K AH N T
PLAIN	P L EY N
PLUM	P L AH M
PLUS	P L AH S
POLISH	P AA L IH SH
POLISH(2)	P OW L IH SH
POMEGRANATE	P AA M EH G R AH N EY T 
PORA	P AO R AH 
PORK	P AO R K
PORRIDGE	P AO R AH JH
POTATO	P AH T EY T OW
POTATOES	P AH T EY T OW Z
POTENCY	P OW T AH N S IY
POUCH	P AW CH
PRUNES	P R UW N Z
PUDDING	P UH D IH NG
PULP	P AH L P
PUNCH	P AH N CH
PUREE	P Y UH R EY
PUREED	P Y UH R IY D 
QUAIL	K W EY L
QUENELLE	K W N EH L 
QUENNELLES	K W EH N IH L Z 
QUICHE	K IY SH
QUINCE	K W IH N S
RAGOUT	R AH G AW T 
RAISINS	R EY Z AH N Z
RAISINS(2)	R EY Z IH N Z
RAMEN	R AA M AH N 
RASPBERRY	R AE Z B EH R IY
RAVIOLI	R AE V IY OW L IY
RED	R EH D
RHUBARB	R UW B AA R B
RICE	R AY S
RICH	R IH CH
RIVIERA	R IH V IY EH R AH
ROASTED	R OW S T AH D
ROASTED(2)	R OW S T IH D
ROSSIYSKIY	R AO S IH IY S K AH IY 
RUSSIAN	R AH SH AH N
RUSSKOYE	R AA S K OY 
RYE	R AY
S	EH S
SA	S AA
SALAD	S AE L AH D
SALMON	S AE M AH N
SALSA	S AO L S AH
SALTED	S AO L T AH D
SALTED(2)	S AO L T IH D
SARDINES	S AA R D IY N Z
SAUCE	S AO S
SAUERKRAUT	S AW ER K R AW T
SAUSAGE	S AO S AH JH
SAUSAGE(2)	S AO S IH JH
SCONE	S K OW N
SCRAMBLED	S K R AE M B AH L D
SEAFOOD	S IY F UW D
SEASONED	S IY Z AH N D
SEAWEED	S IY W IY D
SEMOLINA	S EH M AH L IY N AH
SHORTBREAD	SH AO R T B R EH D 
SHOYUAJI	SH OW UW AA JH IY 
SHREDDED	SH R EH D AH D
SHREDDED(2)	SH R EH D IH D
SHRIMP	SH R IH M P
SKIM	S K IH M
SMOKED	S M OW K T
SMOOTHIE	S M UW DH IY 
SNACK	S N AE K
SNAP	S N AE P
SOCKEYE	S AA K AY 
SOLYANKA	S OW L IY AE NG K AH 
SOUP	S UW P
SOUR	S AW ER
SOUR(2)	S AW R
SOUTHWESTERN	S AW TH W EH S T ER N
SOY	S OY
SPACE	S P EY S
SPAGHETTI	S P AH G EH T IY
SPICE	S P AY S
SPICED	S P AY S T
SPICES	S P AY S AH Z
SPICES(2)	S P AY S IH Z
SPICY	S P AY S IY
SPINACH	S P IH N AH CH
SPLIT	S P L IH T
SPREAD	S P R EH D
STARANISE	S T AA R AA N AH S 
START	S T AA R T
STEAK	S T EY K
STELUTSA	S T IY L AA T Z AH 
STEW	S T UW
STEWED	S T UW D
STRAWBERRIES	S T R AO B EH R IY Z
STRAWBERRY	S T R AO B EH R IY
STRIPS	S T R IH P S
STROGANOFF	S T R OW G AH N AO F
STUFFING	S T AH F IH NG
STURGEON	S T ER JH AH N
STURGEON(2)	S T ER JH IH N
STYLE	S T AY L
SUGAR	SH UH G ER
SULTANA	S AA L T AE N AH 
SUPPL	EH S Y UW P IY P IY EH L 
SWEET	S W IY T
SWORDFISH	S AO R D F IH SH
TABASCO	T AH B AE S K OW
TABLE	T EY B AH L
TABLET	T AE B L AH T
TACO	T AA K OW
TADKA	T AE D K AH 
TAPIOCA	T AE P IY OW K AH 
TEA	T IY
TEMPTER	T EH M P T ER 
TERIYAKI	T EH R IH Y AA K IY
TETRAZZINI	T EH T R AA Z IY N IY 
TIPS	T IH P S
TOAST	T OW S T
TOFFEE	T AA F IY
TOFU	T OW F UW
TOKANA	T AH K AE N AH 
TOMATO	T AH M EY T OW
TOMATO(2)	T AH M AA T OW
TOMATOES	T AH M EY T OW Z
TOMATOES(2)	T AH M AA T OW Z
TOMATOVEGETABLE	T AH M AH T OW V IH JH T AH B AH L 
TONGUE	T AH NG
TOP	T AA P
TOP(2)	T AO P
TORTELLINI	T AO R T EH L IY N IY 
TORTILLAS	T AO R T IY AH Z
TRAIL	T R EY L
TROPICAL	T R AA P IH K AH L
TUNA	T UW N AH
TUNA(2)	T Y UW N AH
TURKEY	T ER K IY
TYPE	T AY P
UNREFINED	AH N R IY F AY N D
UNSALTED	AH N S AA L T AH D 
UTRO	Y UW T R OW 
VANILLA	V AH N IH L AH
VEAL	V IY L
VEG	V EH G 
VEGETABLE	V EH JH T AH B AH L
VEGETABLES	V EH JH T AH B AH L Z
VEGETARIAN	V EH JH AH T EH R IY AH N
VEGGIE	V EH JH IY
VERMICELLI	V ER M IH S EH L IY 
VIN	V IH N
VISIT	V IH Z AH T
VISIT(2)	V IH Z IH T
VITAMIN	V AY T AH M AH N
VOSTOK	V AO S T AA K 
W	D AH B AH L Y UW
WAFFLES	W AA F AH L Z
WAKAME	W AE K AA M 
WAPPLE	W AA P AH L 
WAPPLES	W AA P AH L Z 
WAS	W AA Z
WAS(2)	W AH Z
WAS(3)	W AO Z
WATER	W AO T ER
WBLACK	D AA B AH L Y UW B IY EH L EY S IY K EY 
WBUCKWHEAT	D AA B AH L Y UW B IY Y UW S IY K EY D AA B AH L Y UW EY CH IY EY T IY 
WBUTTER	D AA B AH L Y UW B IY Y UW T IY T IY IY AA R 
WC	D AA B AH L Y UW S IY 
WCANDIED	D AA B AH L Y UW S IY EY EH N D IY AY IY D IY 
WCHICKEN	D AA B AH L Y UW S IY EY CH AY S IY K EY IY EH N 
WCOCOA	D AA B AH L Y UW S IY OW S IY OW EY 
WCOFFEE	D AA B AH L Y UW S IY OW EH F EH F IY IY 
WCRANBERRY	D AA B AH L Y UW S IY AA R EY EH N B IY IY AA R AA R W AY 
WCREAM	D AA B AH L Y UW S IY AA R IY EY EH M 
WDRIED	D AA B AH L Y UW D IY AA R AY IY D IY 
WEGG	W EH 
WHEAT	W IY T
WHEAT(2)	HH W IY T
WHITE	W AY T
WHITE(2)	HH W AY T
WILD	W AY L D
WITH	W IH DH
WITH(2)	W IH TH
WITHOUT	W IH TH AW T
WITHOUT(2)	W IH DH AW T
WLECHO	D AA B AH L Y UW EH L IY S IY EY CH OW 
WMASHED	D AA B AH L Y UW EH M EY EH S EY CH IY D IY 
WMEAT	D AA B AH L Y UW EH M IY EY T IY 
WMILK	D AA B AH L Y UW EH M AY EH L K EY 
WNUTS	D AA B AH L Y UW EH N Y UW T IY EH S 
WONIONS	W AA N Y AH N Z 
WORCESTER	W UH S T ER
WPEACHES	D AA B AH L Y UW P IY IY EY S IY EY CH IY EH S 
WPECTIN	D AA B AH L Y UW P IY IY S IY T IY AY EH N 
WPOTATOES	D AA B AH L Y UW P IY OW T IY EY T IY OW IY EH S 
WPRUNES	D AA B AH L Y UW P IY AA R Y UW EH N IY EH S 
WPULP	D AA B AH L Y UW P IY Y UW EH L P IY 
WRICE	R AY S
WROSEHIPS	R AA S EH HH IH P S 
WSALMON	D AA B AH L Y UW EH S EY EH L EH M OW EH N 
WSHRIMP	D AA B AH L Y UW EH S EY CH AA R AY EH M P IY 
WSUGAR	D AA B AH L Y UW EH S Y UW JH IY EY AA R 
WTEA	D AA B AH L Y UW T IY IY EY 
WTIH	D AA B AH L Y UW T IY AY EY CH 
WTOMACHAKHOKHBILI	D AA B AH L Y UW T IY OW EH M EY S IY EY CH EY K EY EY CH OW K EY EY CH B IY AY EH L AY 
WVEGETABLE	D AA B AH L Y UW V IY IY JH IY IY T IY EY B IY EH L IY 
WVEGETABLES	D AA B AH L Y UW V IY IY JH IY IY T IY EY B IY EH L IY EH S 
YAMS	Y AE M Z
YANTAR	Y AE N T ER 
YOGURT	Y OW G ER T
YUZHNIY	Y AA Z N AH IY 