A	AH
A(2)	EY
ABOUT	AH B AW T
ABOVE	AH B AH V
ADD	AE D
AFTER	AE F T ER
AGAIN	AH G EH N
AGAIN(2)	AH G EY N
AIR	EH R
ALL	AO L
ALMOST	AO L M OW S T
ALONG	AH L AO NG
ALSO	AO L S OW
ALWAYS	AO L W EY Z
ALWAYS(2)	AO L W IY Z
AMERICAN	AH M EH R AH K AH N
AMERICAN(2)	AH M EH R IH K AH N
AN	AE N
AN(2)	AH N
AND	AH N D
AND(2)	AE N D
ANIMALS	AE N AH M AH L Z
ANOTHER	AH N AH DH ER
ANSWER	AE N S ER
ANY	EH N IY
ARE	AA R
ARE(2)	ER
AROUND	ER AW N D
AROUND(2)	ER AW N
AS	AE Z
AS(2)	EH Z
ASKED	AE S K T
ASKED(2)	AE S T
AT	AE T
AWAY	AH W EY
BACK	B AE K
BE	B IY
BECAUSE	B IH K AO Z
BECAUSE(2)	B IH K AH Z
BECAUSE(3)	B IH K AA Z
BEEN	B IH N
BEEN(2)	B AH N
BEFORE	B IH F AO R
BEFORE(2)	B IY F AO R
BEGAN	B IH G AE N
BEGAN(2)	B IY G AE N
BEING	B IY IH NG
BELOW	B IH L OW
BELOW(2)	B IY L OW
BETWEEN	B IH T W IY N
BETWEEN(2)	B IY T W IY N
BIG	B IH G
BOOK	B UH K
BOTH	B OW TH
BOY	B OY
BUT	B AH T
BY	B AY
CALLED	K AO L D
CAME	K EY M
CAN	K AE N
CAN(2)	K AH N
CAR	K AA R
CARRY	K AE R IY
CARRY(2)	K EH R IY
CHANGE	CH EY N JH
CHILDREN	CH IH L D R AH N
CITY	S IH T IY
CLOSE	K L OW S
CLOSE(2)	K L OW Z
COME	K AH M
COULD	K UH D
COUNTRY	K AH N T R IY
CUT	K AH T
DAY	D EY
DID	D IH D
DIFFERENT	D IH F ER AH N T
DIFFERENT(2)	D IH F R AH N T
DO	D UW
DOES	D AH Z
DOES(2)	D IH Z
DOWN	D AW N
EACH	IY CH
EARTH	ER TH
EAT	IY T
END	EH N D
ENOUGH	IH N AH F
ENOUGH(2)	IY N AH F
EVEN	IY V IH N
EVERY	EH V ER IY
EVERY(2)	EH V R IY
EXAMPLE	IH G Z AE M P AH L
EYES	AY Z
FAMILY	F AE M AH L IY
FAMILY(2)	F AE M L IY
FAR	F AA R
FATHER	F AA DH ER
FEET	F IY T
FEW	F Y UW
FIND	F AY N D
FIRST	F ER S T
FOLLOWING	F AA L OW IH NG
FOOD	F UW D
FOR	F AO R
FOR(2)	F ER
FOR(3)	F R ER
FORM	F AO R M
FOUND	F AW N D
FROM	F R AH M
FROM(2)	F ER M
GET	G EH T
GET(2)	G IH T
GIRL	G ER L
GIVE	G IH V
GO	G OW
GOOD	G UH D
GOOD(2)	G IH D
GOT	G AA T
GREAT	G R EY T
GROUP	G R UW P
GROW	G R OW
HAD	HH AE D
HAND	HH AE N D
HARD	HH AA R D
HAS	HH AE Z
HAS(2)	HH AH Z
HAVE	HH AE V
HE	HH IY
HEAD	HH EH D
HEAR	HH IY R
HELP	HH EH L P
HER	HH ER
HERE	HH IY R
HIGH	HH AY
HIM	HH IH M
HIM(2)	IH M
HIS	HH IH Z
HOME	HH OW M
HOUSE	HH AW S
HOW	HH AW
I	AY
IDEA	AY D IY AH
IF	IH F
IMPORTANT	IH M P AO R T AH N T
IN	IH N
INDIANS	IH N D IY AH N Z
INTO	IH N T UW
INTO(2)	IH N T AH
IS	IH Z
IT	IH T
ITS	IH T S
JUST	JH AH S T
JUST(2)	JH IH S T
KEEP	K IY P
KIND	K AY N D
KNOW	N OW
LAND	L AE N D
LARGE	L AA R JH
LAST	L AE S T
LAST(2)	L AO S T
LAST(3)	L AE S
LATER	L EY T ER
LEARN	L ER N
LEAVE	L IY V
LEFT	L EH F T
LET	L EH T
LETTERS	L EH T ER Z
LIFE	L AY F
LIGHT	L AY T
LIKE	L AY K
LINE	L AY N
LIST	L IH S T
LITTLE	L IH T AH L
LIVE	L AY V
LIVE(2)	L IH V
LONG	L AO NG
LOOK	L UH K
MADE	M EY D
MAKE	M EY K
MAN	M AE N
MANY	M EH N IY
MAY	M EY
ME	M IY
MEANS	M IY N Z
MEN	M EH N
MIGHT	M AY T
MILES	M AY L Z
MILES(2)	M AY AH L Z
MISS	M IH S
MORE	M AO R
MOST	M OW S T
MOST(2)	M OW S
MOTHER	M AH DH ER
MOUNTAINS	M AW N T AH N Z
MOVE	M UW V
MUCH	M AH CH
MUST	M AH S T
MY	M AY
NAME	N EY M
NEAR	N IH R
NEED	N IY D
NEVER	N EH V ER
NEW	N UW
NEW(2)	N Y UW
NEXT	N EH K S T
NEXT(2)	N EH K S
NIGHT	N AY T
NO	N OW
NOT	N AA T
NOW	N AW
NUMBER	N AH M B ER
OF	AH V
OFF	AO F
OFTEN	AO F AH N
OFTEN(2)	AO F T AH N
OIL	OY L
OLD	OW L D
ON	AA N
ON(2)	AO N
ONCE	W AH N S
ONE	W AH N
ONE(2)	HH W AH N
ONLY	OW N L IY
OPEN	OW P AH N
OR	AO R
OR(2)	ER
OTHER	AH DH ER
OUR	AW ER
OUR(2)	AW R
OUR(3)	AA R
OUT	AW T
OVER	OW V ER
OWN	OW N
PAGE	P EY JH
PAPER	P EY P ER
PART	P AA R T
PEOPLE	P IY P AH L
PICTURE	P IH K CH ER
PLACE	P L EY S
PLANTS	P L AE N T S
PLAY	P L EY
POINT	P OY N T
PUT	P UH T
READ	R EH D
READ(2)	R IY D
REALLY	R IH L IY
REALLY(2)	R IY L IY
RIGHT	R AY T
RIVER	R IH V ER
RUN	R AH N
SAID	S EH D
SAME	S EY M
SAW	S AO
SAY	S EY
SCHOOL	S K UW L
SEA	S IY
SECOND	S EH K AH N D
SECOND(2)	S EH K AH N
SEE	S IY
SEEMED	S IY M D
SENTENCE	S EH N T AH N S
SET	S EH T
SHE	SH IY
SHOULD	SH UH D
SHOW	SH OW
SIDE	S AY D
SMALL	S M AO L
SO	S OW
SOME	S AH M
SOMETHING	S AH M TH IH NG
SOMETIMES	S AH M T AY M Z
SONG	S AO NG
SOON	S UW N
SOUND	S AW N D
SPELL	S P EH L
STARTED	S T AA R T AH D
STARTED(2)	S T AA R T IH D
STATE	S T EY T
STILL	S T IH L
STOP	S T AA P
STORY	S T AO R IY
STUDY	S T AH D IY
SUCH	S AH CH
TAKE	T EY K
TALKED	T AO K T
TELL	T EH L
THAN	DH AE N
THAN(2)	DH AH N
THAT	DH AE T
THAT(2)	DH AH T
THE	DH AH
THE(2)	DH IY
THEIR	DH EH R
THEM	DH EH M
THEM(2)	DH AH M
THEN	DH EH N
THERE	DH EH R
THESE	DH IY Z
THEY	DH EY
THING	TH IH NG
THINK	TH IH NG K
THIS	DH IH S
THOSE	DH OW Z
THOUGH	DH OW
THOUGHT	TH AO T
THREE	TH R IY
TIME	T AY M
TO	T UW
TO(2)	T IH
TO(3)	T AH
TOGETHER	T AH G EH DH ER
TOO	T UW
TOOK	T UH K
TREES	T R IY Z
TURNED	T ER N D
TWO	T UW
UNDER	AH N D ER
UNTIL	AH N T IH L
UP	AH P
US	AH S
US(2)	Y UW EH S
USE	Y UW S
USE(2)	Y UW Z
VERY	V EH R IY
WALKED	W AO K T
WANT	W AA N T
WANT(2)	W AO N T
WAS	W AA Z
WAS(2)	W AH Z
WAS(3)	W AO Z
WATCH	W AA CH
WATCH(2)	W AO CH
WATER	W AO T ER
WAY	W EY
WE	W IY
WELL	W EH L
WENT	W EH N T
WERE	W ER
WHAT	W AH T
WHEN	W EH N
WHEN(2)	HH W EH N
WHEN(3)	W IH N
WHEN(4)	HH W IH N
WHERE	W EH R
WHERE(2)	HH W EH R
WHICH	W IH CH
WHICH(2)	HH W IH CH
WHILE	W AY L
WHILE(2)	HH W AY L
WHITE	W AY T
WHITE(2)	HH W AY T
WHO	HH UW
WHY	W AY
WHY(2)	HH W AY
WILL	W IH L
WILL(2)	W AH L
WITH	W IH DH
WITH(2)	W IH TH
WITHOUT	W IH TH AW T
WITHOUT(2)	W IH DH AW T
WORDS	W ER D Z
WORK	W ER K
WORLD	W ER L D
WOULD	W UH D
WRITE	R AY T
YEARS	Y IH R Z
YEARS(2)	Y ER Z
YOU	Y UW
YOUNG	Y AH NG
YOUR	Y AO R
YOUR(2)	Y UH R